####################
#---b[------]--1-2-#
#--#################
#------------------#
##--[--]-----b-----#
##-----------#----]#
##########G#####--##
################-E##
#-----------------##
######------------##
######--]--#B#--####
#-------#------b####
############R#######