####################
#------------------#
#----[------]--1-2-#
#--######R##########
#---]###[----------#
##----------------]#
##----------b-----##
##########G#####-E##
#-----------------##
######--[---------##
######--]--#B#--####
#-------#------b####
############R#######