####################
#-----------------##
#--b-[-----]---1-2##
##E#####G###########
#-----[]------S---##
#--------##-------##
###b--------------##
##########B##-----##
#---------######-s##
######------------##
######-----[]-----##
#------------L--####
#########R##########