####################
#-----------------##
#--b-[-----]---1-2##
##E#####G###########
#-----[]------S---##
#--------##-------##
####b-------------##
#############-----##
#---------######-s##
######----#####---##
######-----[]-----##
#------------L--####
####################