####################
#-----------------##
#--b-[-----]---1-2##
##E#####G###########
#-----[]-----#######
#--------[---]----##
####b-------------##
#########B###-----##
#---------######-s##
######------###---##
######-]---[------##
#------------L--####
########R###########