###############1#2##
#------------------#
#---L[------]----RR#
#--#######--------##
#-----------------##
##---[----------RR##
############EEE---##
#---------######--##
#------------------#
####---------------#
#-------]--[##----##
#-------#-------####
######GGGGGGGGG#####