###############1#2##
#---b[------]------#
#--#######--------R#
#------------------#
##----------------R#
##---[------------##
############EEE---##
###############---##
#------------------#
####---------------#
####----]--[##----##
#-------#-------####
######GGGGGGGGG#####