####################
#-----------------##
#--b-[-----]---1-2##
##E#################
#-----[]-##-------##
#--------##-------##
####b----S--------##
#############-----##
#---------###-----##
######----#####---##
######-----[]-----##
#------------L--####
####################