###############1#2##
#-----------------##
#----[------]-----##
##E#################
#-----------------##
#-----L-----------##
#############G##--##
#---------######--##
#---------######--##
######----######--##
#----------[]-----##
#---------------####
#######R######B#####