####################
#----[------]--1-2-#
#--#################
#----]-[-----------#
##-----------------#
##----------S-----##
########G#####b---##
################-E##
#-----------------##
######------------##
######--]-#B#---####
#--------------b####
############R#######