###############1#2##
#---L[------]------#
#--#######--------R#
#------------------#
##----------------R#
##---[------------##
############EEE---##
#---------######--##
#------------------#
####---------------#
#-------]--[##----##
#-------#-------####
######GGGGGGGGG#####