####################
#-----------------##
#--b-[-----]---1-2##
##E#####G###########
#-----[]------S---##
#--------##-------##
####b----------S--##
#############-----##
#---------######-s##
######----#####---##
######-----[]-----##
#------------L--####
#########R##########